5,3,,,,,,
2,4,,,,,,
0,6,,,,,,
0000,0000,0000,0000,0000,0000,0010,0000
0000,0010,0110,0111,0111,0111,1011,0000
0000,1110,1101,1101,1101,1111,1011,0000
0000,1000,0110,0111,0111,1111,1001,0000
0000,0110,1111,1111,1111,1111,0011,0000
0000,1110,1111,1111,1111,1111,1011,0000
0000,1100,1101,1101,1101,1101,1001,0000
0000,0000,0000,0000,0000,0000,0000,0000